1111111111111
1C01C01C01C01
1000000000001
1EP0000000001
1000000000001
10C10C10C10C1
1111111111111